Operadores aritméticos
Nombre del operador	Sintaxis	Sobrecargable	Incluido en C
Suma	a + b	Sí Sí	Sí Sí
Suma y asignación	a += b	Sí Sí	Sí Sí
Resta	a - b	Sí Sí	Sí Sí
Resta y asignación	a -= b	Sí Sí	Sí Sí
Multiplicación	a * b	Sí Sí	Sí Sí
Multiplicación y asignación	a *= b	Sí Sí	Sí Sí
División	a / b	Sí Sí	Sí Sí
División y asignación	a /= b	Sí Sí	Sí Sí
Módulo	a % b	Sí Sí	Sí Sí
Módulo y asignación	a %= b	Sí Sí	Sí Sí
Más unario (promoción entera)	+a	Sí Sí	Sí Sí
Menos unario (opuesto)	-a	Sí Sí	Sí Sí
Incremento prefijo	++a	Sí Sí	Sí Sí
Incremento postfijo	a++	Sí Sí	Sí Sí
Decremento prefijo	--a	Sí Sí	Sí Sí
Decremento postfijo	a--	Sí Sí	Sí Sí

Operadores de comparación
Nombre del operador	Sintaxis	Sobrecargable	Incluido en C
Menor que	a < b	Sí Sí	Sí Sí
Mayor que	a > b	Sí Sí	Sí Sí
Menor o igual que	a <= b	Sí Sí	Sí Sí
Mayor que o igual que	a >= b	Sí Sí	Sí Sí
Igual que	a == b	Sí Sí	Sí Sí
Diferente que / No igual que	a != b	Sí Sí	Sí Sí
Comparación a tres sentidos	a <=> b	Sí Sí	No No
Operadores lógicos
Nombre del operador	Sintaxis	Sobrecargable	Incluido en C
Negación lógica (NOT)	!a	Sí Sí	Sí Sí
Y lógico (AND)	a && b	Sí Sí	Sí Sí
O lógico (OR)	a || b	Sí Sí	Sí Sí
Operadores a nivel de bit
Nombre del operador	Sintaxis	Sobrecargable	Incluido en C
Desplazamiento a la izquierda	a << b	Sí Sí	Sí Sí
Asignación con desplazamiento a la izquierda	a <<= b	Sí Sí	Sí Sí
Desplazamiento a la derecha	a >> b	No No	Sí Sí
Asignación con desplazamiento a la derecha	a >>= b	Sí Sí	Sí Sí
Complemento a uno	~a	Sí Sí	Sí Sí
AND binario	a & b	Sí Sí	Sí Sí
Asignación con AND binario	a &= b	Sí Sí	Sí Sí
OR binario	a | b	Sí Sí	Sí Sí
Asignación con OR binario	a |= b	Sí Sí	Sí Sí
XOR binario	a ^ b	Sí Sí	Sí Sí
Asignación con XOR binario	a ^= b	Sí Sí	Sí Sí
Otros operadores
Nombre del operador	Sintaxis	Sobrecargable	Incluido en C
Asignación básica	a = b	Sí Sí	Sí Sí
Llamada a función	a()	Sí Sí	Sí Sí
Índice de Array	a[b]	Sí Sí	Sí Sí
Indirección (Desreferencia)	*a	Sí Sí	Sí Sí
Dirección de (Referencia) (supresor de dereferencing)	&a	Sí Sí	Sí Sí
Miembro de puntero	a->b	Sí Sí	Sí Sí
Miembro	a.b	No No	Sí Sí
Desreferencia a miembro por puntero	a->*b	Sí Sí	No No
Desreferencia a miembro por objeto	a.*b	No No	No No
Conversión de tipo	(tipo) a	Sí Sí	Sí Sí
Coma	a , b	Sí Sí	Sí Sí
Condicional ternario	a ? b : c	No No	Sí Sí
Resolución de ámbito	a::b	No No	No No
Puntero a función miembro	a::*b	No No	No No
Tamaño de objeto	sizeof a
sizeof(tipo)	No No	Sí Sí
Identificación de tipo	typeid(a)
typeid(tipo)	No No	No No
Asignar almacenamiento	new tipo	Sí Sí	No No
Asignar almacenamiento (Vector)	new tipo[n]	Sí Sí	No No
Desasignar almacenamiento	delete a	Sí Sí	No No
Desasignar almacenamiento (Vector)	delete[] a	Sí Sí	No No
Extensiones del lenguaje
Nombre del operador	Sintaxis	Sobrecargable	Incluido en C	Compilador
Dirección de la etiqueta	&& etiqueta	No No	Sí Sí	GCC / G++
Obtener tipo	typeof a
typeof(expr)	No No	Sí Sí	GCC / G++
min y max	a <? b
a >? b	No No	No No	G++